3,7,10
  0  0  0  1  0  1  0  0  4  5  0  0
  0  1  8  1  0  9  5  4  4  1  4  5
  1  5  5  5  5  4  4  4517  1  1  4
  5 11  4517  4  5  1  1  1  1  4  4
  1  1  5  5  4 10  5  5 10  1  4  4
513  5  4  4  5  1  4  1  5  5  4  4
  4  5  5  4  4  1  1  4  5  5  5  5
  4  4516  1  4  1  1  4  4  5  5  1
  4  1  1  5  4  5  1  5  4  5  1  5
  5  1  1  5  1  1  4  1  4  1  5  1
  5  5  1  1  1  4  4  4  4  1  1  1
  4  4  1  1  5  5  1  4  5  5  1  1
  1  4  4  4  1  5  5  1  1  4  4  1
  5  4  5  5  5  1  4  4  1  4  1  4
  4  1  1  5  1  1  1  1  5  5  1  1
  1  4  1  4  5  1  1  4  4  4  1  4
  5  5  5  1  1  1  4  4  1  1  4  1
  1  5  1  4  4  1  1  5  5  1  4  1
  4  4  1  4  4  1  1  4  1  1  1  1
  1  5  5  1  4  4  1  5  4  4  5  1
  1  4  1  4  1  1  5  1  4  5  1  1
  1  4  1  5  5  1  4  5  5  4  1  1
