3,7,10
  0  0  0  2  0  2  0  0  0  0  0  0
  2  4  0  2  2  5  5  0  0  0  0  0
  5  4  0  4  2  5  4  0517  4  8  5
  5  4  2  2  2  4  4  2  5  5  5  4
  4  5  2  2  4  2  5  4  2  5  4  4
  2  2  5  5  5  5  2  2  4  4  5  4
  5  2  5  2  4  2  2  2  5  5  5  5
  5  5  4  4514  4  2  5  2  2  4  2
  2260  4  4  5  2  4  9  5  4  5  4
  4  2  5  4  5  4  4  2  2  5  2  4
  2  5  5  5  5  2  2  4  5  2  4  4
  5  4  2  5  5  5  4  2  2  2  4  4
  5  5  5  5  4  4  4  5  5  4  5  5
  2  2  4  5  5  5  2  2  2  5  5  4
  4 10  4  4  5  4260  4  5  2  4  2
  4  4  5  4  2  2  2  4  4  5  2  2
  2  5  5  4  2  4  2  5  2  4  4  5
  2  4  5  5  4  5  2  5  4  4  5  5
  5  4  4  5  4  5  5  2  4261  5  4
  5  5  5  5  4  4  5  5  5  5  4  4
  4  2  2  2  2  2  2  2  2  2  2  4
  5  4  4  4  4  4  5  4  5  5  2  4
  5  5  5  5  5  4  5  4  5  5  2  5
  5  2  2  2  2  2  2  2  2  2  2  5
  5  2  5  5  5  5  4  5  5  4  2  5
  5  2  5  4  4  5  5  4  4  5  2  5
  4  2  5  4  5  5  4  5  5  5  2  5
  5  2  2  2  2  2  2  2  2  2  2  4
  4  5  4  4  5  5  4  4  4  5  5  5
  4  4  5  5  5  4  4  2  2  5  4  4
  5  4  2  2  5  4  5  5  5  4  5  5
  4  5  2  4  5  2  5  2  2  4  2  5
  4  5  4  4  2  2  4  5  4  4  4  2
  5  2  4  5  4  4  2  2  5  2  5  4
  4  5  2  5  5  5  4  4  2  2  4  5
